WE  ./w           
EA  ./e     
                
                
SO         ./s  
NO          ./n  

F 220,100,0
C 225,30,255
                             
                                             
111111111111111111111111
1000000000110000000000001
1011000001110000000000001
1001000000000W00000000000111111111
 111111111011000001110000000000001
100000000011000001110111111111111  
111101111111110111000000111111   
111011111111101 10101001
110000001101010111000000111111
100000000000000011000010010001
10000000000000011010100100011
1100000111010101 111011100111
11110111 1110101 101111010001
11111111 1111111 111111111111
