NO ./textures/kanye.xpm
SO ./textures/kanye.xpm
WE ./textures/kanye.xpm
EA ./textures/kanye.xpm

F 29,48,47
C 4,218,219

1111111111111111111111111111111111111111
1000000000001000000000000000000000000001
1011111111101011111111111111111111111101
1000000000101000000000000000000000000101
1111111110101111111111111111111111100101
1000000010100000000000000000000000100101
1011111010111111111111111111111110100101
1010001010000000000E00000000000010100101
1010101011111111111111111111111010100101
1010101000000000000000000000000010100101
1010101111111111111111111111111010100101
1010100000000000000000000000000010100101
1010111111111111111111111111111110100101
1000000000000000000000000000000000100001
1111111111111111111111111111111111111111
